UGC编辑器-游戏策划	三年以上工作经验
腾讯广告产品经理--创意生态产品经理	三年以上工作经验
腾讯游戏高级广告系统运营经理	三年以上工作经验
腾讯云产品服务运营经理/专家	五年以上工作经验
在研UE4射击端游关卡策划	三年以上工作经验
在研UE4射击端游系统策划	三年以上工作经验
QQ会员对外合作产品经理	三年以上工作经验
《王者荣耀世界》系统策划负责人	三年以上工作经验
《王者荣耀世界》资深系统策划	三年以上工作经验
搜狗输入法策略产品经理(语音方向)	三年以上工作经验
搜狗输入法B端高级产品经理（开放平台）	三年以上工作经验
微信视频号直播带货高级行业运营	三年以上工作经验
增长产品运营	三年以上工作经验
和平精英-直播运营	三年以上工作经验
QQ小世界策略产品经理（北京/深圳）	两年以上工作经验
腾讯视频高级产品经理	三年以上工作经验
微信公众号推荐生态策略产品经理	两年以上工作经验
SSV产品运营经理	三年以上工作经验
和平精英-内容生态运营	两年以上工作经验
SSV高级项目经理	五年以上工作经验
在研UE4射击手游世界观叙事策划	三年以上工作经验
《UE4 PVE科幻跨端射击游戏》资深玩法策划	五年以上工作经验
《UE4 PVE科幻跨端射击游戏》武器策划	三年以上工作经验
《UE4 PVE科幻跨端射击游戏》机甲策划	三年以上工作经验
《UE4 PVE科幻跨端射击游戏》怪物策划	三年以上工作经验
《UE4 PVE科幻跨端射击游戏》系统策划	五年以上工作经验
《元梦之星》资深游戏策划	三年以上工作经验
腾讯广告教育行业运营经理（深圳/北京）	三年以上工作经验
广告投放平台产品经理（深圳/北京）	三年以上工作经验
在研自有大IP项目关卡策划	三年以上工作经验
