腾讯云HRBP	三年以上工作经验
HRBP（培训方向）	五年以上工作经验
HR Star-Pro	不限
高级招聘专员（高招）	三年以上工作经验
培训经理(领导力方向)	五年以上工作经验
T族培训经理	五年以上工作经验
高级招聘专员（CDG）	两年以上工作经验
高级招聘专员(WXG)	一年以上工作经验
薪酬福利专家(海外)	十年以上工作经验
领导力培训经理	三年以上工作经验
组织与人才发展经理	五年以上工作经验
专业人才发展经理	两年以上工作经验
薪酬福利(薪资个税管理)	两年以上工作经验
猎聘经理(技术线)	五年以上工作经验
HR交付运营管理	五年以上工作经验
FIT HRBP	五年以上工作经验
魔方HRBP	三年以上工作经验
资深招聘经理	五年以上工作经验
职业发展经理	五年以上工作经验
IEG助理HRBP	一年以上工作经验
薪酬福利经理	五年以上工作经验
人力规划分析师	五年以上工作经验
培训运营经理	三年以上工作经验
领导力培训经理	五年以上工作经验
人才市场洞察与分析研究员	不限
组织发展经理	五年以上工作经验
腾讯广告HRBP（销售运营方向）	五年以上工作经验
腾讯广告HRBP（流量变现方向）	五年以上工作经验
腾讯广告HRBP（电商交易方向）	五年以上工作经验
腾讯广告HRBP（平台产研方向）	五年以上工作经验
