地下城与勇士IP内容策划	三年以上工作经验
腾讯视频电视剧制片人	五年以上工作经验
腾讯视频动漫运营(创新赛道方向)	三年以上工作经验
腾讯视频动漫运营(内容方向)	三年以上工作经验
腾讯视频海外市场渠道拓展BD	三年以上工作经验
游戏内容生态部内容合作运营	三年以上工作经验
腾讯广告达人营销行业运营经理	五年以上工作经验
腾讯文档行业拓展经理(北京/深圳)	三年以上工作经验
商业化内容运营 (药企方向）	五年以上工作经验
腾讯新闻内容运营	三年以上工作经验
腾讯视频影视责编	两年以上工作经验
腾讯视频预算管理	两年以上工作经验
腾讯视频海外版基础运营（泰语方向）	两年以上工作经验
标准化内容运营	两年以上工作经验
商业化内容运营 （公关代理/广告4A客户方向）	五年以上工作经验
腾讯视频SNS运营	三年以上工作经验
微信读书出品内容运营	三年以上工作经验
微信读书高级内容生态运营经理	五年以上工作经验
腾讯视频TV端商务	三年以上工作经验
理财通内容生态运营	三年以上工作经验
《王者荣耀》动画番剧导演	五年以上工作经验
腾讯视频IP授权拓展经理(广州)	三年以上工作经验
PUBGM海外内容运营经理	两年以上工作经验
海外电竞内容&社群运营(MOBA类)	三年以上工作经验
腾讯视频动漫制片人	五年以上工作经验
《王者荣耀》资深影视编剧	三年以上工作经验
《王者荣耀》动画制片人	五年以上工作经验
互动影游项目负责人	八年以上工作经验
《元梦之星》内容社群运营	三年以上工作经验
腾讯新闻娱乐垂类运营	三年以上工作经验
