高级投资分析师/投资经理（海外Fintech方向）	两年以上工作经验
商业分析经理（广告技术战略）	两年以上工作经验
商业分析经理(PCG社交方向)	三年以上工作经验
智慧零售商业项目经理	八年以上工作经验
智慧零售商业项目经理	八年以上工作经验
腾讯云前瞻技术研究经理（半导体/电子方向）	三年以上工作经验
制裁风险专项管理	三年以上工作经验
高级商业分析师(碳中和方向)	一年以上工作经验
QQ战略分析资深经理	五年以上工作经验
商业分析(电竞方向)	三年以上工作经验
智慧零售运动潮流商业分析师	五年以上工作经验
腾讯地图业务策略分析经理	三年以上工作经验
高级金融咨询和项目管理经理	五年以上工作经验
高级商业分析师(互联网金融方向)	一年以上工作经验
Fundraising Senior Associate（Hong Kong/Beijing)	五年以上工作经验
 Investment Associate (Overseas) 	两年以上工作经验
高级投资分析师/投资经理（内容娱乐方向）	三年以上工作经验
市场与用户研究经理	两年以上工作经验
SSV-可持续项目评估体系咨询师	三年以上工作经验
SSV-可持续项目评估体系咨询师	三年以上工作经验
反洗钱风险分析师	三年以上工作经验
Fund Investment Analyst/Sr. Analyst 	一年以上工作经验
智慧零售商业项目经理	八年以上工作经验
高级商业分析经理	三年以上工作经验
金融产品风险管理经理/高级经理	三年以上工作经验
国际业务风险管理专家	三年以上工作经验
尽职调查合规管理岗	五年以上工作经验
洗钱风险管理与政策研究	三年以上工作经验
CSIG高级经营分析经理	五年以上工作经验
游戏战略与产品分析	三年以上工作经验
