高级核心交易开发工程师	三年以上工作经验
AI产品架构师	三年以上工作经验
微信看一看推荐数据平台开发工程师	三年以上工作经验
操作系统高级研发工程师（深圳/北京/上海）	五年以上工作经验
服务器资源供应交付经理	三年以上工作经验
运营开发工程师	三年以上工作经验
腾讯会议iOS开发工程师	三年以上工作经验
UE4引擎高级工程师	五年以上工作经验
《元梦之星》资深游戏客户端开发（UE4）	五年以上工作经验
搜狗输入法服务端开发组组长	五年以上工作经验
搜狗输入法iOS客户端高级研发工程师(业务研发方向)	五年以上工作经验
搜狗输入法语音解码器开发工程师	三年以上工作经验
数据库运营开发Lead	五年以上工作经验
理财通核心交易高级开发工程师	五年以上工作经验
创新大世界SOC项目 UE-Gameplay开发工程师（深圳）	三年以上工作经验
linux内核高级研发工程师	五年以上工作经验
操作系统高级研发工程师	五年以上工作经验
云网络后台研发工程师（北京/深圳）	三年以上工作经验
媒资后台开发工程师	三年以上工作经验
云游戏wifi技术专家	五年以上工作经验
START云游戏web开发工程师	三年以上工作经验
微信小游戏客户端工程师	两年以上工作经验
微信后台开发工程师-基础组件工程师	一年以上工作经验
高级安全工程师	五年以上工作经验
微信客户端跨平台开发工程师(客户端开发)(广州)	不限
3D动作手游高级游戏客户端开发工程师	三年以上工作经验
《UE4 PVE科幻跨端射击游戏》客户端开发工程师	三年以上工作经验
元梦之星资深测试开发工程师	三年以上工作经验
海外网络高级规划工程师	五年以上工作经验
腾讯专有云高级测试工程师(深圳)(北京)(成都)	五年以上工作经验
