Senior Legal Counsel,Cloud	三年以上工作经验
微信内容生态治理	三年以上工作经验
策略运营经理	五年以上工作经验
公共事务高级经理	五年以上工作经验
高级法律顾问（保险方向）	五年以上工作经验
企业发展（高级）法律顾问	三年以上工作经验
数字内容研究员	十年以上工作经验
公共事务高级经理/专家	五年以上工作经验
专家法律顾问	五年以上工作经验
高级法律顾问(PCG新闻与公共法务组)	五年以上工作经验
知识产权部专利工程师	一年以上工作经验
高级法律顾问(PCG社交线法务组)	五年以上工作经验
腾讯可持续价值传播研究经理	五年以上工作经验
数据隐私合规经理/专家	三年以上工作经验
公共事务高级经理	五年以上工作经验
公司事务及国际监管法务中心高级法律顾问	八年以上工作经验
游戏维权诉讼律师	五年以上工作经验
高级法律顾问/专家法律顾问	十年以上工作经验
支付业务政务经理	三年以上工作经验
境外金融公共事务高级经理	五年以上工作经验
微信高级法律顾问	五年以上工作经验
Senior Legal Counsel	五年以上工作经验
建设工程法律顾问（深圳）	三年以上工作经验
Senior Legal Counsel, Corporate Affairs and International Regulatory	
Senior Legal Counsel, Cloud	
IEG- International Game Compliance Manager	
Trust & Safety Manager	
Trust & Safety Manager	
