科技文化品牌营销高级经理	五年以上工作经验
产业互联网高级公关经理	五年以上工作经验
Level Infinite 高级市场品牌经理	五年以上工作经验
高级赛事经理（FPS产品）   	三年以上工作经验
PUBGM高级品牌经理	五年以上工作经验
传播策略研究员	一年以上工作经验
腾讯电竞高级公关经理	三年以上工作经验
腾讯云高级公关经理	五年以上工作经验
微信视频号高级公关经理	三年以上工作经验
腾讯技术传播高级公关经理	五年以上工作经验
二次元项目高级品牌经理（上海）	三年以上工作经验
射击RPG游戏资深市场营销经理	五年以上工作经验
和平精英-资深产品营销经理	三年以上工作经验
腾讯游戏市场营销经理	两年以上工作经验
微信支付市场营销经理	不限
Level Infinite Senior Lead- 市场营销	八年以上工作经验
腾讯游戏公关传播经理	三年以上工作经验
PCG技术高级公关经理	五年以上工作经验
腾讯云国际内容营销及公关传播经理	五年以上工作经验
腾讯游戏资深公关策略	三年以上工作经验
腾讯集团高级品牌经理	三年以上工作经验
腾讯智慧零售高级公关经理	五年以上工作经验
产业互联网视频传播高级公关经理	三年以上工作经验
电竞业务部商业拓展(教育内容)	三年以上工作经验
资深媒介经理	五年以上工作经验
腾讯广告To B私域策略运营	三年以上工作经验
腾讯游戏媒介经理	三年以上工作经验
穿越火线-创意指导	五年以上工作经验
海外IP产品-内容营销	三年以上工作经验
知名IP手游/创新射击端游-海外品牌经理	三年以上工作经验
