《穿越火线手游》3D动作设计师	五年以上工作经验
王者荣耀资深交互设计师	五年以上工作经验
和平精英-资深2D角色设计师	三年以上工作经验
《暗区突围》手游3D动作设计师	三年以上工作经验
《王者荣耀》分镜指导	五年以上工作经验
预研项目主美术	三年以上工作经验
《UE4 PVE科幻跨端射击游戏》3D特效设计师	三年以上工作经验
《UE4 PVE科幻跨端射击游戏》原画设计师	五年以上工作经验
《UE4 PVE科幻跨端射击游戏》技术美术（工具向）	三年以上工作经验
《UE4 PVE科幻跨端射击游戏》技术美术（UI）	三年以上工作经验
《UE4 PVE科幻跨端射击游戏》技术美术（PCG）	三年以上工作经验
《UE4 PVE科幻跨端射击游戏》高级品控导演	五年以上工作经验
《UE4 PVE科幻跨端射击游戏》3D场景设计师	五年以上工作经验
《UE4 PVE科幻跨端射击游戏》高级游戏视觉设计师	五年以上工作经验
《UE4 PVE科幻跨端射击游戏》技术美术	三年以上工作经验
《UE4 PVE科幻跨端射击游戏》武器概念设计师	五年以上工作经验
《UE4 PVE科幻跨端射击游戏》3D角色设计师	三年以上工作经验
《UE4 PVE科幻跨端射击游戏》3D动作设计师	三年以上工作经验
《元梦之星》资深场景地编	五年以上工作经验
UE5-PC主机开放世界-资深执行导演	五年以上工作经验
《洛克王国》开放世界手游资深3D动画设计师	五年以上工作经验
高级/资深技术美术(动画方向)	五年以上工作经验
UI开发	三年以上工作经验
高级2D场景概念设计师	十年以上工作经验
高级2D角色概念设计师	八年以上工作经验
腾讯游戏高级设计师(UI视觉设计)	三年以上工作经验
3A写实射击游戏3D场景地编高级美术师	五年以上工作经验
魔方高级美宣设计师	三年以上工作经验
《王者荣耀》资深影视3D角色	五年以上工作经验
WeGame高级设计师(视觉设计方向)	三年以上工作经验
