S2WXG风控经理	三年以上工作经验
S2采购风控经理	三年以上工作经验
S2游戏风险管理(数据方向)	两年以上工作经验
IEG风险管理经理(游戏业务)	三年以上工作经验
业务风控经理	不限
财经IT需求统筹(BA)	五年以上工作经验
CDG财务管理	五年以上工作经验
IT审计经理	两年以上工作经验
发票管理	三年以上工作经验
账务中心总账会计(资金核算)	三年以上工作经验
IEG财务管理（投资公司管理）	五年以上工作经验
WXG风险管理经理	三年以上工作经验
商业运营财务管理	五年以上工作经验
反舞弊调查经理	五年以上工作经验
应付会计(CSIG子公司)	一年以上工作经验
总账会计	一年以上工作经验
IEG财务管理-米大师外汇管理	五年以上工作经验
财务核算高级产品经理	八年以上工作经验
财务管理(海外发行)	五年以上工作经验
IEG财务管理（海外工作室及投资公司财管）	五年以上工作经验
Treasury Manager - Singapore	
Accounts Payable Accountant	
Accounts Receivable Accountant	
IT Internal Control Manager	
