腾讯广告食品饮料行业方案策划（广州）	三年以上工作经验
腾讯云教育企业行业销售经理	三年以上工作经验
腾讯广告运营商政务行业销售经理（广州/深圳）	三年以上工作经验
腾讯广告本地生活旅游行业销售经理（广州）	三年以上工作经验
政务行业BD	五年以上工作经验
CSIG经管投标策略高级经理	三年以上工作经验
腾讯广告食饮垂直行业销售（上海/深圳/广州）	三年以上工作经验
Tencent GamesSenior Business Development Director 	十年以上工作经验
天美游戏全球IP/品牌合作及研发资深商务经理	五年以上工作经验
智慧零售大客户销售经理	五年以上工作经验
智慧零售大客户销售经理	五年以上工作经验
医疗行业KA销售	五年以上工作经验
45121-境外钱包商务拓展经理	两年以上工作经验
流量生态部高级商务经理	三年以上工作经验
跨境业务BD	五年以上工作经验
腾讯广告效果渠道经理（上海/深圳）	三年以上工作经验
腾讯广告大健康行业销售经理（全国）	五年以上工作经验
腾讯文档商业化广告招商经理(深圳/北京)	三年以上工作经验
王者电影商务制片商务制片(深圳/成都/北京)	五年以上工作经验
平台商务合作经理	三年以上工作经验
腾讯广告家居行业销售经理	三年以上工作经验
智慧零售大客户销售经理	五年以上工作经验
海外KA合作厂商-商务合作经理	三年以上工作经验
腾讯广告本地餐饮行业销售经理（上海/广州）	三年以上工作经验
PC应用宝高级商务经理	不限
腾讯金融云保险大客户经理	五年以上工作经验
腾讯云泛互联网销售(电商方向(上海/深圳))	五年以上工作经验
高级商务经理(客户接待)	三年以上工作经验
商务拓展	三年以上工作经验
番剧/CG商务制片商务拓展	五年以上工作经验
